设计模式

创建类
- 单例	Singleton
- 工厂	Factory
- 抽象工厂	Abstract Factory
- 建造者	Builder
- 原型	Prototype


结构型
- 适配器	Adpter
- 桥接	Bridge
- 过滤器	Filter
- 组合	Composite
- 装饰者	Decorator
- 外观	Facade
- 享元	Flyweight
- 代理	Proxy

行为型
- 责任链	Chain of Responsibility
- 命令	Command
- 解释权	Interpreter
- 迭代器	Iterator
- 中介者	Mediator
- 备忘录	Memento
- 观察者	Observer
- 状态	State
- 空对象	Null Object
- 策略	Strategy
- 模板	Template
- 访问者	Visitor

J2EE
- MVC
- DAO
- 业务代表	Business Delegate
- 组合实体	Composite Entity
- FC
- 拦截器/过滤器
- 服务定位	Service Locate
- TO

